🟦🟦🟦🟦🟦🟦🟦🟦🟦🟦🟦🟦🟦🟦🟦🟦🟦🟦🟦🟦🟦🟦🟦🟦🟦🟦🟦🟦🟦🟦🟦🟦🟦🟦🟦🟦🟦🟦
🟦✅✅✅✅✅✅🟦🟦✅🟦✅🟦✅✅✅✅✅✅✅✅✅✅✅✅🟦✅✅✅🟦✅✅✅✅✅🟦✅🟦
🟦✅🟦🟦🟦🟦🟦🟦🟦✅🟦✅🟦🟦🟦✅🟦✅🟦🟦🟦✅✅🟦🟦🟦✅🟦🟦🟦🟦🟦🟦🟦✅🟦✅🟦
🟦✅✅✅✅✅✅✅🟦✅✅✅✅✅✅✅🟦✅🟦✅✅✅✅✅✅🟦✅✅✅✅✅🟦✅🟦✅✅✅🟦
🟦🟦🟦🟦🟦✅🟦🟦🟦🟦🟦✅🟦🟦🟦✅🟦✅🟦✅🟦✅✅🟦🟦🟦✅🟦🟦🟦🟦🟦✅🟦✅🟦🟦🟦
🟦✅✅✅🟦✅🟦✅🟦✅🟦✅✅✅🟦✅🟦✅🟦✅🟦✅✅✅✅🟦✅🟦✅✅✅🟦✅🟦✅✅✅🟦
🟦✅🟦🟦🟦✅🟦✅🟦✅🟦✅🟦🟦🟦✅🟦🟦🟦🟦🟦✅✅🟦🟦🟦✅🟦✅🟦🟦🟦✅🟦🟦🟦✅🟦
🟦✅✅✅✅✅✅✅🟦✅✅✅✅✅🟦✅✅✅🟦✅✅✅✅🟦✅✅✅✅✅🟦✅🟦✅🟦✅✅✅🟦
🟦🟦🟦✅🟦🟦🟦🟦🟦🟦🟦🟦🟦✅🟦🟦🟦🟦🟦🟦🟦✅✅🟦✅✅✅🟦🟦🟦✅🟦🟦🟦✅🟦✅🟦
🟦✅✅✅✅✅✅✅✅✅✅✅✅✅🟦✅✅✅✅✅✅✅🟦🟦🟦🟦✅✅✅🟦✅✅✅✅✅🟦✅🟦
🟦✅🟦✅🟦🟦🟦🟦🟦🟦✅🟦✅🟦🟦🟦✅✅✅✅🟦🟦✅✅✅🟦✅🟦🟦🟦✅🟦🟦🟦✅🟦✅🟦
🟦✅🟦✅🟦✅✅✅✅✅✅🟦✅🟦✅🟦✅✅✅✅✅✅✅🟦🟦🟦✅✅✅🟦✅🟦✅🟦🟦🟦✅🟦
🟦✅🟦✅🟦✅🟦🟦🟦🟦🟦🟦🟦🟦✅🟦✅✅🟦✅✅✅✅🟦✅✅✅🟦🟦🟦✅✅✅🟦✅✅✅🟦
🟦✅🟦✅🟦✅🟦✅✅✅✅✅✅🟦✅✅✅✅🟦🟦🟦🟦✅🟦🟦🟦✅✅✅🟦✅🟦🟦🟦🟦🟦✅🟦
🟦🟦🟦✅🟦🟦🟦✅✅🟦✅🟦🟦🟦🟦🟦✅✅🟦✅✅🟦✅✅✅✅✅🟦✅🟦🟦🟦✅🟦✅🟦✅🟦
🟦✅✅✅✅✅🟦✅✅🟦✅🟦✅✅✅✅✅✅🟦✅✅🟦✅🟦🟦🟦✅🟦✅✅✅🟦✅🟦✅🟦✅🟦
🟦✅🟦✅🟦✅🟦✅✅🟦✅✅✅✅✅✅✅✅✅✅✅✅✅✅✅✅✅🟦✅🟦✅🟦✅✅✅✅✅🟦
🟦✅🟦✅🟦🟦🟦🟦🟦🟦🟦🟦✅🟦✅🟦✅🟦🟦🟦🟦🟦✅🟦🟦🟦✅🟦✅🟦🟦🟦✅🟦🟦🟦🟦🟦
🟦🟦🟦✅✅✅✅✅✅🟦✅🟦✅🟦✅🟦✅✅✅✅✅🟦✅✅✅🟦✅✅✅✅✅🟦✅🟦✅✅✅🟦
🟦✅✅✅✅✅✅✅✅🟦✅🟦🟦🟦🟦🟦🟦🟦🟦✅🟦🟦🟦🟦🟦🟦🟦🟦🟦🟦🟦🟦✅🟦✅🟦🟦🟦
🟦🟦🟦🟦🟦✅✅🟦✅✅✅✅✅✅✅✅✅✅🟦✅✅🟦✅✅✅✅✅🟦🟡✅✅🟦✅🟦✅✅✅🟦
🟦✅✅✅🟦✅✅🟦🟦🟦🟦✅✅✅🟦🟦🟦🟦🟦🟦🟦🟦✅🟦🟦🟦🟦🟦✅🟦✅🟦✅🟦🟦🟦✅🟦
🟦✅🟦🟦🟦✅✅🟦✅✅✅✅✅✅🟦✅✅✅✅✅✅✅✅🟦✅✅✅✅✅🟦✅✅✅✅✅✅✅🟦
🟦✅🟦✅✅✅✅🟦✅✅✅✅✅✅🟦✅✅🟦✅🟦✅🟦✅🟦✅🟦🟦🟦🟦🟦🟦🟦🟦🟦🟦🟦🟦🟦
🟦✅🟦✅🟦✅✅🟦🟦🟦🟦🟦✅🟦🟦🟦✅🟦✅🟦✅🟦✅✅✅✅✅✅✅🟦✅✅✅🟦✅🟦✅🟦
🟦✅🟦✅🟦✅✅✅✅🟦✅✅✅✅✅🟦✅🟦✅🟦🟦🟦🟦🟦🟦🟦🟦🟦✅🟦🟦🟦✅🟦✅🟦✅🟦
🟦✅🟦✅🟦🟦🟦🟦✅🟦🟦🟦✅🟦✅🟦✅🟦✅✅✅🟦✅🟦✅✅✅🟦✅🟦✅🟦✅✅✅✅✅🟦
🟦✅🟦✅✅✅✅🟦✅🟦✅✅✅🟦✅🟦✅🟦🟦🟦✅🟦✅🟦✅🟦🟦🟦🟦🟦✅🟦✅✅✅✅✅🟦
🟦✅🟦🟦🟦🟦✅🟦🟦🟦✅🟦🟦🟦🟦🟦✅✅✅🟦🟦🟦✅✅✅✅✅✅✅✅✅🟦✅🟦🟦🟦🟦🟦
🟦✅✅✅✅✅✅✅✅🟦✅✅✅🟦✅🟦✅✅✅✅✅🟦✅🟦🟦🟦✅✅✅✅✅🟦✅🟦✅✅✅🟦
🟦🟦🟦🟦✅🟦✅🟦🟦🟦🟦🟦✅🟦✅🟦✅✅✅✅✅🟦✅🟦✅✅✅✅✅🟦🟦🟦✅🟦✅🟦🟦🟦
🟦✅✅🟦✅🟦✅🟦✅🟦✅🟦✅🟦✅🟦✅🟦🟦🟦🟦🟦🟦🟦🟦🟦✅✅✅🟦✅✅✅🟦✅🟦✅🟦
🟦✅✅🟦✅🟦🟦🟦✅🟦✅🟦✅🟦✅✅✅✅✅✅✅✅✅✅✅✅✅✅✅✅✅🟦✅🟦✅🟦✅🟦
🟦✅✅✅✅🟦✅✅✅🟦✅✅✅🟦✅✅✅✅✅✅✅✅✅✅✅✅✅✅✅✅✅🟦✅✅✅✅✅🟦
🟦✅✅🟦✅🟦✅🟦✅🟦🟦✅✅🟦🟦🟦✅🟦🟦🟦🟦🟦🟦🟦✅🟦🟦✅✅🟦🟦🟦✅🟦🟦🟦✅🟦
🟦✅✅🟦✅🟦✅🟦✅✅✅✅✅✅✅🟦✅✅✅🟦✅✅✅✅✅✅🟦✅✅✅✅🟦✅🟦✅✅✅🟦
🟦🟦🟦🟦🟦🟦🟦🟦🟦🟦🟦🟦🟦🟦🟦🟦🟦🟦🟦🟦🟦🟦🟦🟦🟦🟦🟦🟦🟦🟦🟦🟦🟦🟦🟦🟦🟦🟦

